###################
#--------#--------#
#=##-#########-##=#
#-----------------#
#-##-#-#####-#-##-#
#----#---#---#----#
####-### # ###-####
   #-#   1   #-#
####-# # # # #-####
    -  #234#  -
####-# ##### #-####
   #-#       #-#
####-# ##### #-####
#--------#--------#
#=##-#########-##=#
#--#-----0-----#--#
##-#-#-#####-#-#-##
#----#---#---#----#
#-######-#-######-#
#-----------------#
###################